0 - guillermo
1 - helen
2 - paul
3 - syra
4 - olena
5 - shira
6 - barack
7 - frank
8 - ladan
9 - dmitri
A - ariella
B - jose
C - mutya
D - manuel
E - kylie
F - sanya
G - daniel
H - kathryn
I - gertrudes
J - vilma
K - jabir
L - laozi
M - precious
N - pepe
O - joseph
P - mary
Q - christopher
R - anthony
S - catalina
T - villaflor
U - lorde
V - sophie
W - melquiades
X - avelino
Y - gottfried
Z - isaac
α - fernando
β - john
γ - iggy
δ - jessie
ε - natalie
ϛ - emma
ζ - peter
η - andrew
θ - andres
ι - karl
κ - karol
λ - babatunde
μ - ferdinand
ν - erap
ξ - fidel
ο - mao
π - hiroshi
ϻ - arci 
ϟ - coleen
ρ - juday
σ - andi
τ - valerie
υ - julia
φ - solenn
χ - janine
ψ - kim
ω - yeng
ϡ - maja
